11111
1EPC1
11001
1C001
11111
