11111
1EPC1
11001
10001
11111

