11110
10001
10001
10001
11111
