111111111111111111111111111111
1C0E00000000000000000000000001
111111110000000000000000000001
1C00000C1000000000000000000001
101111110000000000000000000001
101000000000000000000000110111
1010000000000000000000010C10C1
101000000000000000000001001001
101000000000000000000001001001
100000000111000000011111001001
100000000000000000000000000001
100000000000000000011111111111
100000000000000000100000000001
111111111111011111000000000001
100000000000P00000000000000001
100000000001010000000000000001
100000000001010000000000000001
100000000001010000000000000001
100000000001010000000000000001
100000000001010000000000000001
100000000001010000000000000001
100000000001010000000000000001
100000000001010000000000000001
100000000001010000000000000101
111111111111111111111111111111
