1111111111111111
1P001100001100E1
1000000100000111
1000110010110001
1111111001111111
1111111101111111
111111C00C111111
1111110111111111
111111C00C111111
1111111111111111
