111111111111111111111111111111111111111
1P00001000100000000000000000101000001C1
101110101010111111111011111010101010101
101000101000000010001000100000101010001
101111101111111110101110111110101011111
100000101000100000100000100010101000001
101110101011101110111111101010101111101
100010000010001000100000101010101000001
111011111110111011101110101011101011101
101000100000100000101010101000001000101
101110101011111111101010101111111110111
101000101010000000001010100010000010001
101011101110111111111010111010101111101
101000100000100000000010001010101000101
101110111111101111111011101010101010101
100010100000000010001010100010101010001
101010111110111011101010111111101011101
101010100010100010001010000010001010001
101010101011101110111011101010101010111
1C10000010000010000000000010001010100E1
111111111111111111111111111111111111111
