1111111111111111111111111111111
1000000000000000000000000000011
1111111100000000000000000000011
1000000010000000000000000000011
1011111100000000000000000000011
1010000000000C00000000001101111
1010000000CE0000000000010010011
1010000000C00000000000010010011
1010000000001000000000010010011
1000000001110100000111110010011
1000000000010100000000000000011
1000000000000000000111111111111
1000000000000000001000000000011
1111111111110111110000000000011
100000010000P000010000000000011
1000000011110111100000000000011
1000000000010100000000000000011
1000000000010100000000000000011
1000000000010100000000000000011
1000000000010100000000000000011
1000000000010100000000000000011
1111111111111111111111111111111
