1111111111111111111111111111111
1000000000000000000000000000011
1111111100000000000000000000011
1000000010000000000000000000011
1011111100000000000000000000011
1010000000000C00000000001101111
1010000000CE0000000000010010011
1010000000C00000000000010010011
1010000000000000000000010010011
1000000001111000000111110010011
100000000001T100000000000000011
1000000000000000000111111111111
1000000000000000001000000000011
1111111111110111110000000000011
10000001T000P000T10000000000011
1000000011110111100000000000011
1000000000010100000000000000011
1000000000010100000000000000011
100000000001T100000000000000011
1000000000010100000000000000011
1000000000010100000000000000011
1000000000010100000000000000011
1000000000010100000000000000011
1000000000010100000000000001011
1000000000010100000000000001011
1000000000010100000000000001011
1000000000010100000000000001011
1000000000010100000000000001011
1000000000010100000000000001011
1111111111111111111111111111111
