111111111111111111111111111111
100000000000000T00000000000001
111111110000000000000000000001
1T00000010000000000000000000T1
101111110000000000000000000001
1010000000000C000000000011T111
1010000000CE000000000001001001
1010000000C0000000000001001001
101000000000000000000001001001
100000000111000000011111001001
1T00000000000C0000000000000001
100000000000000000011111111111
100000000000000000100000000001
111111111111011111000000000001
100000000000P00000000000000001
100000000001010000000000000001
100000000001010000000000000001
100000000001010000000000000001
100000000001010000000000000001
100000000001010000000000000001
100000000001010000000000000001
100000000001010000000000000001
100000000001010000000000000001
1000000000010100000T0000000101
111111111111111111111111111111
