1111111111111111111111111111111
1TC000000000000000000000T000C11
1111111100000000000000000000011
1T00000C10000000000000000000011
10111111000000000000T0000000T11
1010000000000C00000000001101111
1010000000CE0000000000010010C11
1010000000C00000000000010010011
1010000000001000000000010010011
1000000001110100000111110T10011
1000000000010100000000000000011
1000000000000000000111111111111
1000000000000000001000000000011
1111111111110111110000000000011
1T0000000000P000000000000000011
1000000011110111100000000000011
1000000000010100000000000000011
1000000000010100000000000000011
100000T000010100000000T00000011
100000000001010000000000000C011
1C00000000010100000000000000011
1111111111111111111111111111111
