11111111111111
1P000000000001
10000000000101
10000000000101
10000000000101
10000000000101
10000000000101
10000000000101
10000000000101
10000000000101
10000000000101
10000000000101
10000000000101
10000000000101
10000000000101
10000000000101
10000000000101
10000000011101
100000001E0001
10000000011101
11111111111111
