11111111111111
1P000000000001
10000000000101
10000000000101
10000000000101
10000000000101
10000000000101
10000000000101
10000000000101
10000000000101
10000000000101
10000000000101
10000000000101
10000000000101
10000000000101
10000000000101
10000000000101
100000000111B1
100000001E00B1
100000000111B1
11111111111111
