111111111111111111111111111111111111111
1P0000100010000000000T000000101000001C1
101110101010111111111011111010101010101
101000101000000010001000100000101010001
101111101111111110101110111110101011111
1T00001010001000001000001000101T1000001
101110101011101110111111101010101111101
100010000010001000100000101010101000001
1110111111101110111011101T1011101011101
101000100000100000101T10101000001000101
101110101011111111101010101111111110111
1010001010100000000010101000100000100T1
101011101110111111111010111010101111101
10100010000010000000001T001010101000101
1T1110111111101111111011101010101010101
100010100000000010001010100010101010001
101010111110111011101010111111101011101
101010100010100010001010000010001010001
101010101011101110111011101010101010111
1C1T0000100000100000000000100010101T0E1
111111111111111111111111111111111111111
